******************************
*                            *
**********                  *
*            *               *
*                    * ******
*            *               *
******             **********
*            ****            *
******************************
